########
##   #>#
## # # #
#@ #   #
########
